Address A,Port A,Address B,Port B,Packets,Bytes,Stream ID,Packets A to B,Bytes A to B,Packets B to A,Bytes B to A,Rel Start,Duration,Bits/s A to B,Bits/s B to A,Flows
198.18.0.1,60868,198.18.0.84,443,4104,2986614,61,1741,116924,2363,2869690,11.269577,236.980248,3947.0,96875.0,266
198.18.0.1,60863,198.18.0.88,443,514,183964,56,257,117601,257,66363,11.268176,236.981503,3969.0,2240.0,116
198.18.0.1,60848,198.18.0.86,443,265,74969,49,118,29407,147,45562,11.262653,236.985416,992.0,1538.0,69
198.18.0.1,60991,198.18.0.124,443,11192,8952091,130,4853,314929,6339,8637162,18.781064,229.470056,10979.0,301116.0,54
198.18.0.1,60901,198.18.0.100,443,133,22184,76,61,8342,72,13842,11.287344,236.960093,281.0,467.0,29
198.18.0.1,60865,198.18.0.84,443,5364,4162538,58,2334,148164,3030,4014374,11.26899,236.98061,5001.0,135517.0,27
198.18.0.1,60769,198.18.0.176,443,1651,1283354,7,718,49824,933,1233530,6.242344,2.605301,152992.0,3787754.0,26
198.18.0.1,60899,198.18.0.99,443,116,19326,75,54,7292,62,12034,11.28627,236.961316,246.0,406.0,23
198.18.0.1,60913,198.18.0.90,443,581,421534,82,242,17556,339,403978,12.153349,235.915333,595.0,13699.0,21
198.18.0.1,60944,198.18.0.106,443,124,57828,101,65,30542,59,27286,13.941398,234.310037,1042.0,931.0,20
198.18.0.1,60961,198.18.0.115,443,10341,8220755,113,4518,276820,5823,7943935,14.858595,233.390264,9488.0,272297.0,20
198.18.0.1,60934,198.18.0.95,443,622,466727,95,259,18072,363,448655,13.831033,170.326528,848.0,21072.0,16
198.18.0.1,60910,198.18.0.26,443,97,21564,80,45,5612,52,15952,12.062634,236.185129,190.0,540.0,15
198.18.0.1,61038,198.18.0.175,443,200,126794,149,115,118184,85,8610,64.070346,184.185765,5133.0,373.0,15
198.18.0.1,61051,198.18.0.42,443,93,21346,155,45,9247,48,12099,76.004429,172.24507699999998,429.0,561.0,13
198.18.0.1,60831,198.18.0.181,443,118,24300,40,58,6309,60,17991,8.928802,239.320236,210.0,601.0,13
198.18.0.1,60923,198.18.0.103,443,177,88704,87,76,7001,101,81703,13.091479,235.155792,238.0,2779.0,12
198.18.0.1,60847,198.18.0.85,443,79,12578,48,38,4544,41,8034,11.261058,236.987088,153.0,271.0,11
198.18.0.1,60909,198.18.0.6,443,168,87218,79,76,7639,92,79579,12.062443,236.186118,258.0,2695.0,10
198.18.0.1,60919,198.18.0.12,443,132,59814,85,59,5821,73,53993,12.652678,235.595736,197.0,1833.0,10
198.18.0.1,60921,198.18.0.103,443,380,254067,86,164,12148,216,241919,12.66074,235.588456,412.0,8214.0,10
198.18.0.1,60790,198.18.0.177,443,271,146062,14,119,10757,152,135305,6.247481,2.605827000000001,33024.0,415392.0,10
198.18.0.1,60871,198.18.0.6,443,84,18251,62,40,4948,44,13303,11.269777,236.980221,167.0,449.0,9
198.18.0.1,60837,198.18.0.11,443,116,43087,43,54,6650,62,36437,10.680943,237.568143,223.0,1226.0,9
198.18.0.1,60929,198.18.0.19,443,81,16005,92,39,6578,42,9427,13.425098,234.822833,224.0,321.0,9
198.18.0.1,61052,198.18.0.42,443,74,15018,156,37,5021,37,9997,76.004605,172.244037,233.0,464.0,9
198.18.0.1,61013,198.18.0.78,443,88,25496,143,43,7757,45,17739,26.191708,222.057614,279.0,639.0,9
198.18.0.1,60849,198.18.0.87,443,77,12659,50,38,4821,39,7838,11.262957,236.985037,162.0,264.0,9
198.18.0.1,60907,198.18.0.102,443,81,13010,78,39,5513,42,7497,12.006741,236.243147,186.0,253.0,9
198.18.0.1,60924,198.18.0.104,443,611,442485,88,261,17671,350,424814,13.092907,235.157276,601.0,14452.0,9
198.18.0.1,60931,198.18.0.104,443,80,20321,93,37,4718,43,15603,13.509904,234.740438,160.0,531.0,9
198.18.0.1,60953,198.18.0.111,443,83,17256,109,40,5763,43,11493,14.310808,233.93674,197.0,393.0,9
198.18.0.1,60915,198.18.0.12,443,795,592168,83,346,23047,449,569121,12.255615,235.992652,781.0,19292.0,8
198.18.0.1,60839,198.18.0.81,443,116,42510,44,51,5689,65,36821,10.684825,237.563905,191.0,1239.0,8
198.18.0.1,60935,198.18.0.109,443,227,151550,96,96,7886,131,143664,13.831928,165.193695,381.0,6957.0,8
198.18.0.1,61080,198.18.0.167,443,49,14451,163,23,4291,26,10160,123.456558,122.339962,280.0,664.0,8
198.18.0.1,60762,198.18.0.169,443,59,15684,1,27,7041,32,8643,0.002101,171.774681,327.0,402.0,8
198.18.0.1,60774,198.18.0.6,443,37,14336,12,18,3403,19,10933,6.2436,2.5949940000000007,10490.0,33704.0,7
198.18.0.1,60905,198.18.0.12,443,655,490630,77,284,19183,371,471447,11.434021,236.815395,648.0,15926.0,7
198.18.0.1,60773,198.18.0.19,443,34,15337,11,17,3500,17,11837,6.243392,2.595032,10789.0,36491.0,7
198.18.0.1,60799,198.18.0.19,443,36,14911,19,17,3220,19,11691,6.425528,2.412598000000001,10677.0,38766.0,7
198.18.0.1,60843,198.18.0.52,443,37,6836,46,15,1759,22,5077,10.934063,105.457442,133.0,385.0,7
198.18.0.1,61044,198.18.0.78,443,71,18404,152,34,6881,37,11523,65.419846,182.836315,301.0,504.0,7
198.18.0.1,60955,198.18.0.91,443,70,13004,110,34,4871,36,8133,14.427904,233.819402,166.0,278.0,7
198.18.0.1,60939,198.18.0.92,443,70,14073,97,34,4766,36,9307,13.931714,234.31552,162.0,317.0,7
198.18.0.1,60872,198.18.0.101,443,227,142047,63,99,7987,128,134060,11.270027,236.98006,269.0,4525.0,7
198.18.0.1,60972,198.18.0.135,443,854,682113,121,361,26182,493,655931,16.019429,0.3754550000000023,557872.0,13976236.0,7
198.18.0.1,60797,198.18.0.157,443,36,15102,18,17,3582,19,11520,6.344276,2.4942590000000004,11488.0,36948.0,7
198.18.0.1,60807,198.18.0.161,443,41,18635,24,19,3381,22,15254,6.610479,2.228351,12138.0,54763.0,7
198.18.0.1,60764,198.18.0.175,443,39,14689,4,18,3387,21,11302,4.406399,4.428735999999999,6118.0,20415.0,7
198.18.0.1,60832,198.18.0.179,443,82,20174,41,39,4564,43,15610,8.928997,239.320251,152.0,521.0,7
198.18.0.1,60833,198.18.0.180,443,83,21770,42,40,8369,43,13401,8.92918,239.319749,279.0,447.0,7
198.18.0.1,61040,198.18.0.180,443,79,27028,150,39,13433,40,13595,64.302142,183.953915,584.0,591.0,7
198.18.0.1,61120,198.18.0.197,443,45,16066,173,21,3981,24,12085,193.481743,54.774284,581.0,1765.0,7
198.18.0.1,60766,198.18.0.7,443,28,10081,5,13,3530,15,6551,6.232309,2.6053170000000003,10839.0,20115.0,6
198.18.0.1,60801,198.18.0.9,443,34,13713,20,16,3834,18,9879,6.553462,2.2998840000000005,13336.0,34363.0,6
198.18.0.1,60852,198.18.0.83,443,1555,1230480,52,674,43158,881,1187322,11.265029,120.172649,2873.0,79041.0,6
198.18.0.1,60927,198.18.0.105,443,65,10747,91,32,4016,33,6731,13.292378,234.956113,136.0,229.0,6
198.18.0.1,60989,198.18.0.122,443,61,13329,129,30,4612,31,8717,18.547562,229.703754,160.0,303.0,6
198.18.0.1,60845,198.18.0.173,443,37,9192,47,17,1904,20,7288,10.986061,75.19870700000001,202.0,775.0,6
198.18.0.1,60792,198.18.0.178,443,183,87317,16,77,7628,106,79689,6.247922,2.607164,23406.0,244523.0,6
198.18.0.1,61035,198.18.0.218,443,34,12414,148,14,3462,20,8952,59.829679,105.163358,263.0,680.0,6
198.18.0.1,60827,198.18.0.14,5228,72,17436,38,35,3781,37,13655,8.87348,239.34988,126.0,456.0,4
198.18.0.1,60855,198.18.0.83,443,26,8339,55,11,2492,15,5847,11.265732,57.808388,344.0,809.0,4
198.18.0.1,60882,198.18.0.91,443,28,8052,66,14,2624,14,5428,11.274167,64.729547,324.0,670.0,4
198.18.0.1,60883,198.18.0.92,443,28,8027,67,14,2599,14,5428,11.275049,64.72864200000001,321.0,670.0,4
198.18.0.1,60891,198.18.0.95,443,27,8290,70,11,2423,16,5867,11.282834,57.792257,335.0,812.0,4
198.18.0.1,60896,198.18.0.96,443,28,8035,73,14,2593,14,5442,11.285199,64.71795399999999,320.0,672.0,4
198.18.0.1,60956,198.18.0.110,443,115,53381,111,53,5386,62,47995,14.430355,233.820851,184.0,1642.0,4
198.18.0.1,61007,198.18.0.120,443,27,11300,140,11,3129,16,8171,25.079908,45.110512,554.0,1449.0,4
198.18.0.1,60975,198.18.0.135,443,732,550855,122,319,22062,413,528793,16.395294,231.856044,761.0,18245.0,4
198.18.0.1,60791,198.18.0.178,443,111,61308,15,49,5438,62,55870,6.247701,2.6068489999999995,16688.0,171456.0,4
198.18.0.1,61009,198.18.1.15,443,31,14372,141,13,3257,18,11115,25.191758,45.11706,577.0,1970.0,4
198.18.0.1,60959,198.18.1.25,443,33,14440,112,14,3275,19,11165,14.63702,45.909933,570.0,1945.0,4
198.18.0.1,60971,198.18.1.26,443,67,15972,120,33,4257,34,11715,15.630337,232.620718,146.0,402.0,4
198.18.0.1,60978,198.18.1.27,443,33,14337,124,14,3243,19,11094,16.73231,45.449955,570.0,1952.0,4
198.18.0.1,60983,198.18.1.28,443,33,12999,125,14,3245,19,9754,17.188258,45.7646,567.0,1705.0,4
198.18.0.1,60987,198.18.1.29,443,31,14340,128,13,3223,18,11117,17.956387,46.10061,559.0,1929.0,4
198.18.0.1,60997,198.18.1.31,443,33,14443,134,14,3275,19,11168,24.073705,45.276296,578.0,1973.0,4
198.18.0.1,61003,198.18.1.32,443,31,14307,137,13,3191,18,11116,24.361749,45.716555,558.0,1945.0,4
198.18.0.1,60840,198.18.0.81,443,28,7041,45,14,2623,14,4418,10.684968,65.318701,321.0,541.0,3
198.18.0.1,60850,198.18.0.83,443,18,7284,51,9,2388,9,4896,11.264234,0.0927980000000001,205866.0,422078.0,3
198.18.0.1,60854,198.18.0.83,443,18,7222,54,9,2324,9,4898,11.265472,0.0919369999999997,202225.0,426204.0,3
198.18.0.1,60866,198.18.0.84,443,22,10291,59,11,2429,11,7862,11.269249,0.0926329999999993,209774.0,678980.0,3
198.18.0.1,60874,198.18.0.89,443,32,10757,64,16,2669,16,8088,11.270644,64.733088,329.0,999.0,3
198.18.0.1,60864,198.18.0.90,443,26,7204,57,13,2578,13,4626,11.268438,64.73476099999999,318.0,571.0,3
198.18.0.1,60887,198.18.0.93,443,28,8351,69,14,2554,14,5797,11.276437,64.726945,315.0,716.0,3
198.18.0.1,60892,198.18.0.94,443,32,10761,71,16,2673,16,8088,11.283086,64.720253,330.0,999.0,3
198.18.0.1,60893,198.18.0.97,443,32,10800,72,16,2712,16,8088,11.284203,64.71901799999999,335.0,999.0,3
198.18.0.1,60898,198.18.0.98,443,32,10732,74,16,2644,16,8088,11.286017,64.717113,326.0,999.0,3
198.18.0.1,61011,198.18.0.106,443,23,3680,142,12,2641,11,1039,25.3094,62.984977,335.0,131.0,3
198.18.0.1,60804,198.18.0.9,443,12,6465,22,6,2136,6,4329,6.559165,0.0408879999999998,417922.0,846996.0,2
198.18.0.1,60916,198.18.0.12,443,19,10701,84,10,2297,9,8404,12.25593,0.0958850000000008,191646.0,701173.0,2
198.18.0.1,60853,198.18.0.83,443,14,6910,53,7,2116,7,4794,11.265267,0.0919410000000002,184118.0,417137.0,2
198.18.0.1,60759,198.18.0.169,443,20,5961,0,11,5047,9,914,0.0,5.525065,7307.0,1323.0,2
198.18.0.1,60768,198.18.0.176,443,12,6529,6,6,2113,6,4416,6.242071,0.034885,484563.0,1012698.0,2
198.18.0.1,60770,198.18.0.176,443,12,6465,8,6,2049,6,4416,6.242597,0.0353649999999996,463509.0,998953.0,2
198.18.0.1,60771,198.18.0.176,443,12,6561,9,6,2145,6,4416,6.242869,0.0373679999999998,459216.0,945407.0,2
198.18.0.1,60772,198.18.0.176,443,11,5237,10,6,2145,5,3092,6.243167,0.0373049999999999,459991.0,663074.0,2
198.18.0.1,60777,198.18.0.176,443,12,6561,13,6,2145,6,4416,6.24386,0.0293220000000005,585226.0,1204829.0,2
198.18.0.1,61042,10.201.3.133,7680,12,715,151,5,343,7,372,64.817709,50.00237000000001,54.0,59.0,1
198.18.0.1,61114,10.203.168.228,7680,12,715,171,5,343,7,372,185.019563,45.06497400000001,60.0,66.0,1
198.18.0.1,61135,10.203.199.2,7680,10,611,177,5,343,5,268,225.125986,15.012361,182.0,142.0,1
198.18.0.1,61069,10.208.174.26,7680,12,715,160,5,343,7,372,104.847467,50.00097,54.0,59.0,1
198.18.0.1,61001,121.248.49.141,7680,12,715,136,5,343,7,372,24.31671,45.008252,60.0,66.0,1
198.18.0.1,61090,192.168.31.22,7680,12,715,166,5,343,7,372,144.886832,50.001024,54.0,59.0,1
198.18.0.1,60802,198.18.0.8,443,13,2490,21,6,2118,7,372,6.557663,45.006955000000005,376.0,66.0,1
198.18.0.1,60805,198.18.0.8,443,13,2426,23,6,2054,7,372,6.563545,45.002418,365.0,66.0,1
198.18.0.1,60940,198.18.0.8,443,13,2522,98,6,2150,7,372,13.934154,45.003579,382.0,66.0,1
198.18.0.1,60942,198.18.0.8,443,14,2542,99,6,2118,8,424,13.936225,45.001542,376.0,75.0,1
198.18.0.1,60951,198.18.0.8,443,13,2426,107,6,2054,7,372,14.106915,45.001825,365.0,66.0,1
198.18.0.1,60952,198.18.0.8,443,13,2458,108,6,2086,7,372,14.108337,45.002323,370.0,66.0,1
198.18.0.1,60985,198.18.0.8,443,13,2426,126,6,2054,7,372,17.880753,45.002248,365.0,66.0,1
198.18.0.1,60986,198.18.0.8,443,12,2406,127,5,2034,7,372,17.88169,45.001341,361.0,66.0,1
198.18.0.1,60994,198.18.0.8,443,13,2522,132,6,2150,7,372,19.975209,45.00213900000001,382.0,66.0,1
198.18.0.1,60995,198.18.0.8,443,13,2522,133,6,2150,7,372,19.976119,45.00200600000001,382.0,66.0,1
198.18.0.1,61005,198.18.0.8,443,13,2426,138,6,2054,7,372,24.976195,45.002937,365.0,66.0,1
198.18.0.1,61006,198.18.0.8,443,14,2542,139,6,2118,8,424,24.977532,60.001873,282.0,56.0,1
198.18.0.1,61150,198.18.0.8,443,10,2270,181,6,2054,4,216,248.162848,0.0020739999999932,,,1
198.18.0.1,61151,198.18.0.8,443,10,2270,182,6,2054,4,216,248.165239,0.0018029999999953,,,1
198.18.0.1,60815,198.18.0.10,443,13,2472,28,6,2100,7,372,6.913875,45.087071,372.0,66.0,1
198.18.0.1,60817,198.18.0.10,443,13,2472,29,6,2100,7,372,6.999688,45.094234,372.0,65.0,1
198.18.0.1,61050,198.18.0.42,443,10,2298,154,6,2082,4,216,76.00377,0.0751360000000005,221678.0,22998.0,1
198.18.0.1,60867,198.18.0.84,443,10,2265,60,6,2049,4,216,11.269416,0.0928710000000005,176502.0,18606.0,1
198.18.0.1,60881,198.18.0.84,443,10,2265,65,6,2049,4,216,11.273973,0.0884110000000006,185406.0,19545.0,1
198.18.0.1,60884,198.18.0.84,443,10,2265,68,6,2049,4,216,11.275312,0.0871329999999996,188126.0,19831.0,1
198.18.0.1,60933,198.18.0.95,443,10,2287,94,6,2071,4,216,13.83076,0.0851950000000005,194471.0,20282.0,1
198.18.0.1,60943,198.18.0.107,443,13,2424,100,6,2052,7,372,13.940553,45.002049,364.0,66.0,1
198.18.0.1,60945,198.18.0.107,443,13,2488,102,6,2116,7,372,13.941705,45.000862,376.0,66.0,1
198.18.0.1,60947,198.18.0.108,443,13,2522,103,6,2150,7,372,13.948082,45.001452,382.0,66.0,1
198.18.0.1,60948,198.18.0.108,443,13,2522,104,6,2150,7,372,13.949527,45.000979,382.0,66.0,1
198.18.0.1,60949,198.18.0.108,443,13,2426,105,6,2054,7,372,14.002469,45.002558,365.0,66.0,1
198.18.0.1,60950,198.18.0.108,443,13,2522,106,6,2150,7,372,14.003909,45.001583,382.0,66.0,1
198.18.0.1,60968,198.18.0.113,443,13,2514,117,6,2142,7,372,15.060203,45.002367,380.0,66.0,1
198.18.0.1,60970,198.18.0.113,443,13,2418,119,6,2046,7,372,15.061784,45.001782000000006,363.0,66.0,1
198.18.0.1,60967,198.18.0.114,443,12,2464,116,6,2144,6,320,15.060055,45.001539,381.0,56.0,1
198.18.0.1,60969,198.18.0.114,443,13,2516,118,6,2144,7,372,15.060846,45.00171,381.0,66.0,1
198.18.0.1,60963,198.18.0.115,443,10,2275,114,6,2059,4,216,14.867616,0.0794540000000001,207314.0,21748.0,1
198.18.0.1,60965,198.18.0.115,443,10,2307,115,6,2091,4,216,14.923383,0.0391710000000014,427050.0,44114.0,1
198.18.0.1,60808,198.18.0.160,443,13,2458,25,6,2086,7,372,6.610664,45.002544,370.0,66.0,1
198.18.0.1,60809,198.18.0.160,443,13,2490,26,6,2118,7,372,6.612486,45.002067,376.0,66.0,1
198.18.0.1,60819,198.18.0.179,443,10,2265,34,6,2049,4,216,8.793169,0.0442889999999991,370114.0,39016.0,1
198.18.0.1,60823,198.18.0.179,443,10,2297,36,6,2081,4,216,8.837776999999999,0.0908200000000007,183307.0,19026.0,1
198.18.0.1,60820,198.18.0.180,443,10,2299,35,6,2083,4,216,8.796209,0.0413450000000015,403047.0,41794.0,1
198.18.0.1,60824,198.18.0.180,443,10,2267,37,6,2051,4,216,8.837928,0.090720000000001,180864.0,19047.0,1
198.18.0.1,60828,198.18.0.181,443,10,2336,39,6,2120,4,216,8.873722,0.0549029999999994,308908.0,31473.0,1
198.18.0.1,60993,198.18.1.30,443,13,2465,131,6,2093,7,372,19.060718,50.220215,333.0,59.0,1
198.18.0.1,60999,198.18.1.30,443,13,2497,135,6,2125,7,372,24.280085,45.135226,376.0,65.0,1
198.18.0.165,443,198.18.0.1,60646,21,1169,2,12,701,9,468,1.204197,134.98209400000002,41.0,27.0,1
10.201.108.124,7680,198.18.0.1,60729,3,156,3,3,156,0,0,4.252245,30.001087,41.0,0.0,0
198.18.0.1,60811,198.18.0.5,80,7,380,27,4,216,3,164,6.688358,0.0387069999999996,44643.0,33895.0,0
198.18.0.1,60977,198.18.0.5,80,7,380,123,4,216,3,164,16.689014,0.1202119999999986,14374.0,10914.0,0
198.18.0.1,61015,198.18.0.5,80,7,380,144,4,216,3,164,26.6887,0.0338560000000001,51039.0,38752.0,0
198.18.0.1,61020,198.18.0.5,80,7,380,145,4,216,3,164,36.692087,0.039360000000002,43902.0,33333.0,0
198.18.0.1,61027,198.18.0.5,80,7,380,146,4,216,3,164,46.684477,0.0335169999999962,51555.0,39144.0,0
198.18.0.1,61031,198.18.0.5,80,7,380,147,4,216,3,164,56.696418,0.3906479999999988,4423.0,3358.0,0
198.18.0.1,61046,198.18.0.5,80,7,380,153,4,216,3,164,66.716719,0.3388869999999997,5099.0,3871.0,0
198.18.0.1,61056,198.18.0.5,80,7,380,157,4,216,3,164,76.724048,0.0586920000000077,29441.0,22353.0,0
198.18.0.1,61060,198.18.0.5,80,7,380,158,4,216,3,164,86.724116,0.0095570000000009,180809.0,137281.0,0
198.18.0.1,61065,198.18.0.5,80,7,380,159,4,216,3,164,96.715963,0.3138849999999991,5505.0,4179.0,0
198.18.0.1,61071,198.18.0.5,80,7,380,161,4,216,3,164,106.721751,0.3434239999999988,5031.0,3820.0,0
198.18.0.1,61075,198.18.0.5,80,7,380,162,4,216,3,164,116.721344,0.3391479999999944,5095.0,3868.0,0
198.18.0.1,61082,198.18.0.5,80,7,380,164,4,216,3,164,126.722371,0.0831450000000018,20782.0,15779.0,0
198.18.0.1,61086,198.18.0.5,80,7,380,165,4,216,3,164,136.725286,0.3395429999999919,5089.0,3864.0,0
198.18.0.1,61092,198.18.0.5,80,7,380,167,4,216,3,164,146.720855,0.0348280000000045,49615.0,37670.0,0
198.18.0.1,61097,198.18.0.5,80,7,380,168,4,216,3,164,156.724159,0.0845770000000243,20431.0,15512.0,0
198.18.0.1,61105,198.18.0.5,80,7,380,169,4,216,3,164,166.723023,0.0327069999999878,52832.0,40113.0,0
198.18.0.1,61109,198.18.0.5,80,7,380,170,4,216,3,164,176.717808,0.0351550000000031,49153.0,37320.0,0
198.18.0.1,61116,198.18.0.5,80,7,380,172,4,216,3,164,186.73984,0.3395330000000172,5089.0,3864.0,0
198.18.0.1,61122,198.18.0.5,80,7,380,174,4,216,3,164,196.740203,0.0301069999999867,57395.0,43577.0,0
198.18.0.1,61126,198.18.0.5,80,7,380,175,4,216,3,164,206.737365,0.0773159999999961,22349.0,16969.0,0
198.18.0.1,61131,198.18.0.5,80,7,380,176,4,216,3,164,216.739287,0.0320190000000195,53967.0,40975.0,0
198.18.0.1,61137,198.18.0.5,80,7,380,178,4,216,3,164,226.732101,0.0326440000000047,52934.0,40191.0,0
198.18.0.1,61141,198.18.0.5,80,7,380,179,4,216,3,164,236.743576,0.0796600000000182,21692.0,16469.0,0
198.18.0.1,61146,198.18.0.5,80,7,380,180,4,216,3,164,246.743274,0.0336729999999931,51317.0,38962.0,0
198.18.0.6,443,198.18.0.1,60727,3,156,17,3,156,0,0,6.343128,30.000737,41.0,0.0,0
198.18.0.6,443,198.18.0.1,60682,2,104,32,2,104,0,0,8.262841,15.000465,55.0,0.0,0
198.18.0.160,443,198.18.0.1,60753,3,156,30,3,156,0,0,8.019281,30.000703,41.0,0.0,0
198.18.0.160,443,198.18.0.1,60751,3,156,31,3,156,0,0,8.019323,30.000595,41.0,0.0,0
198.18.0.219,443,198.18.0.1,58560,34,1768,33,17,884,17,884,8.510418,240.009419,29.0,29.0,0
198.18.0.239,443,198.18.0.1,60101,34,1768,81,17,884,17,884,12.130239,240.006692,29.0,29.0,0
198.18.1.20,80,198.18.0.1,60086,32,1664,90,16,832,16,832,13.164815,225.007764,29.0,29.0,0
198.18.1.20,443,198.18.0.1,60082,32,1664,89,16,832,16,832,13.105527,225.006282,29.0,29.0,0
