Address A,Port A,Address B,Port B,Packets,Bytes,Stream ID,Packets A to B,Bytes A to B,Packets B to A,Bytes B to A,Rel Start,Duration,Bits/s A to B,Bits/s B to A,Flows
192.168.5.2,61105,221.5.100.174,2011,3018,3115982,54,941,301881,2077,2814101,12.033479,29.30793,82402,768147,99
192.168.5.2,58499,120.53.53.53,443,247,51083,4,125,13264,122,37819,1.104591,35.96638,2950,8412,64
192.168.5.2,59490,223.5.5.5,443,227,32653,5,108,12081,119,20572,1.104591,35.919709,2690,4581,64
192.168.5.2,61009,221.5.100.174,2011,1117,1122786,7,329,65522,788,1057264,3.33847,8.52167,61510,992541,42
192.168.5.2,61131,221.5.100.174,2011,467,415702,69,174,44282,293,371420,14.409074,26.931506,13153,110330,35
192.168.5.2,61149,221.5.100.174,2011,260,145123,78,122,86399,138,58724,14.789861,26.553314,26030,17692,35
192.168.5.2,61113,221.5.100.174,2011,289,157661,60,146,130740,143,26921,13.993012,27.348443000000003,38244,7874,34
192.168.5.2,61175,221.5.100.174,2011,31505,28607308,91,13125,1178118,18380,27429190,18.620962,22.724585000000005,414746,9656216,31
192.168.5.2,61118,221.5.100.174,2011,294,245940,61,114,26704,180,219236,14.078379,27.264867,7835,64327,27
192.168.5.2,61008,112.82.180.41,443,737,654286,8,207,18518,530,635768,3.338475,8.266960000000001,17920,615237,24
192.168.5.2,61136,221.5.100.174,2011,94,37530,71,42,20148,52,17382,14.453312,26.887885,5994,5171,21
192.168.5.2,61103,221.5.100.174,2011,96,57840,53,41,22217,55,35623,11.836021,29.506346,6023,9658,19
192.168.5.2,61143,221.5.100.174,2011,397,355629,75,144,37643,253,317986,14.742272,26.600937,11320,95631,19
192.168.5.2,61047,221.5.100.174,2011,78,44696,27,35,19102,43,25594,5.450595,6.187313,24698,33092,17
192.168.5.2,61060,221.5.100.174,2011,102,77530,32,43,16353,59,61177,6.486215,5.150857,25398,95016,17
192.168.5.2,61069,221.5.100.174,2011,537,565264,36,157,33357,380,531907,8.465023,3.172851999999999,84106,1341145,17
192.168.5.2,61120,221.5.100.174,2011,239,214818,63,88,22826,151,191992,14.079675,27.261582,6698,56340,17
192.168.5.2,61099,221.5.100.174,2011,92,52043,50,46,31001,46,21042,11.827719,29.514677,8402,5703,15
192.168.5.2,61129,221.5.100.174,2011,60,27200,68,28,14994,32,12206,14.396559,26.943854,4451,3624,15
192.168.5.2,61141,221.5.100.174,2011,52,22126,74,26,13929,26,8197,14.543815,26.798599,4158,2446,15
192.168.5.2,61173,221.5.100.174,2011,169,137765,90,66,21232,103,116533,18.569218,22.774081,7458,40935,15
192.168.5.2,61177,221.5.100.174,2011,392,382528,92,134,27809,258,354719,18.628703,22.714628,9794,124930,15
192.168.5.2,61066,221.5.100.174,2011,63,33889,34,30,20427,33,13462,8.444468,3.1934240000000003,51172,33724,13
192.168.5.2,61119,221.5.100.174,2011,88,58904,62,40,15632,48,43272,14.079486,27.264001000000004,4586,12697,13
192.168.5.2,61181,221.5.100.174,2011,57,29966,94,25,14750,32,15216,19.253366,22.090981,5341,5510,13
192.168.5.2,61133,221.5.100.174,2011,103,87668,70,39,12644,64,75024,14.425865,26.914525999999995,3758,22299,11
192.168.5.2,61183,221.5.100.174,2011,64,35655,95,32,18509,32,17146,19.533513,21.809768,6789,6289,11
192.168.5.2,61025,61.156.44.221,443,158,95482,16,76,9408,82,86074,3.343127,8.277321,9092,83190,10
192.168.5.2,61035,121.43.167.86,443,31,12824,21,17,4144,14,8680,3.680405,7.931633999999999,4179,8754,10
192.168.5.2,61010,221.5.100.174,2011,41,22334,9,21,11327,20,11007,3.338475,8.298625000000001,10919,10610,9
192.168.5.2,61073,221.5.100.174,2011,49,29548,39,24,16096,25,13452,9.153053,2.4823699999999995,51873,43352,9
192.168.5.2,61095,221.5.100.174,2011,48,22378,49,22,10665,26,11713,11.739283,29.604185,2882,3165,9
192.168.5.2,61100,221.5.100.174,2011,42,17980,52,21,11419,21,6561,11.828339,29.513096,3095,1778,9
192.168.5.2,61107,221.5.100.174,2011,58,29181,55,30,19903,28,9278,12.090529,29.253204,5442,2537,9
192.168.5.2,61121,221.5.100.174,2011,43,22865,64,21,11691,22,11174,14.079688,27.263451,3430,3278,9
192.168.5.2,61146,221.5.100.174,2011,44,26915,76,20,12545,24,14370,14.746264,26.598051,3773,4322,9
192.168.5.2,61151,221.5.100.174,2011,79,55471,79,35,14342,44,41129,14.912725,26.433373,4340,12447,9
192.168.5.2,61155,221.5.100.174,2011,65,42612,81,29,12839,36,29773,15.111066,26.232684,3915,9079,9
192.168.5.2,61159,221.5.100.174,2011,56,32514,83,26,15340,30,17174,15.387169,25.953187,4728,5293,9
192.168.5.2,61169,221.5.100.174,2011,52,32071,88,23,10852,29,21219,18.482035,22.861677,3797,7425,9
192.168.5.2,60998,221.5.100.174,2011,32,16433,6,15,7796,17,8637,1.104631,10.528145,5923,6562,7
192.168.5.2,61031,221.5.100.174,2011,35,18186,20,17,8462,18,9724,3.520947,8.116825,8340,9584,7
192.168.5.2,61039,221.5.100.174,2011,38,19958,22,18,7733,20,12225,3.702652,7.935169,7796,12324,7
192.168.5.2,61041,221.5.100.174,2011,31,16166,23,15,7215,16,8951,3.742674,7.895183,7310,9069,7
192.168.5.2,61050,221.5.100.174,2011,34,19919,28,16,8576,18,11343,5.45464,6.183160999999999,11095,14675,7
192.168.5.2,61056,221.5.100.174,2011,76,60277,30,31,9710,45,50567,6.38949,5.247629,14802,77089,7
192.168.5.2,61058,221.5.100.174,2011,87,73339,31,35,9453,52,63886,6.401579,5.239713,14432,97541,7
192.168.5.2,61062,221.5.100.174,2011,53,36736,33,24,9847,29,26889,6.499785,5.135744,15338,41885,7
192.168.5.2,61071,221.5.100.174,2011,32,16708,38,16,7745,16,8963,8.763663,2.871730000000001,21575,24968,7
192.168.5.2,61075,221.5.100.174,2011,38,19914,40,18,9612,20,10302,9.171152,2.4666870000000003,31173,33411,7
192.168.5.2,61109,221.5.100.174,2011,41,23816,56,19,9508,22,14308,12.218192,29.12224,2611,3930,7
192.168.5.2,61111,221.5.100.174,2011,40,22317,57,20,11411,20,10906,12.393305,28.949887000000004,3153,3013,7
192.168.5.2,61147,221.5.100.174,2011,41,23736,77,19,9619,22,14117,14.746265,26.596893,2893,4246,7
192.168.5.2,61153,221.5.100.174,2011,45,26190,80,21,11223,24,14967,14.928306,26.417763,3398,4532,7
192.168.5.2,61157,221.5.100.174,2011,32,9463,82,17,5920,15,3543,15.360523,25.982792,1822,1090,7
192.168.5.2,61161,221.5.100.174,2011,45,24406,84,20,10113,25,14293,15.571705,25.769529,3139,4437,7
192.168.5.2,61163,221.5.100.174,2011,48,27559,85,23,12284,25,15275,15.892443,25.45082,3861,4801,7
192.168.5.2,61165,221.5.100.174,2011,31,16424,86,16,8143,15,8281,16.260982,25.082133,2597,2641,7
192.168.5.2,61167,221.5.100.174,2011,35,16676,87,17,8107,18,8569,18.274541,23.065040000000003,2811,2972,7
192.168.5.2,61171,221.5.100.174,2011,31,16315,89,16,7659,15,8656,18.56563,22.777718,2689,3040,7
192.168.5.2,61179,221.5.100.174,2011,60,40792,93,26,10262,34,30530,18.74416,22.599068000000003,3632,10807,7
192.168.5.2,61198,221.5.100.174,2011,49,29450,99,26,18306,23,11144,36.995419,4.328464000000004,33833,20596,7
192.168.5.2,61029,221.5.100.174,2011,32,13936,19,15,6941,17,6995,3.359021,8.276486,6709,6761,6
192.168.5.2,61088,221.5.100.174,2011,41,22397,45,20,12663,21,9734,11.600967,0.3316499999999998,305454,234801,6
192.168.5.2,61089,221.5.100.174,2011,34,18029,46,15,6805,19,11224,11.600984,0.3157300000000003,172425,284394,6
192.168.5.2,61023,222.134.1.28,443,59,39215,15,27,5066,32,34149,3.3428,8.276372,4896,33008,6
192.168.5.2,61125,221.5.100.174,2011,45,24487,65,22,9501,23,14986,14.279118,27.061441,2808,4430,5
192.168.5.2,61051,221.5.100.174,2011,27,15806,29,13,5879,14,9927,5.454683,6.18049,7609,12849,4
192.168.5.2,61091,221.5.100.174,2011,32,15648,47,14,5894,18,9754,11.640068,29.678566000000004,1588,2629,4
192.168.5.2,61101,221.5.100.174,2011,27,12639,51,13,4726,14,7913,11.828336,29.51543,1280,2144,4
192.168.5.2,61028,222.134.1.28,443,79,61751,18,32,4618,47,57133,3.35885,8.257401,4474,55352,4
192.168.5.2,61137,221.5.100.174,2011,28,16711,72,12,4547,16,12164,14.453314,0.1340399999999988,271381,725992,3
192.168.5.2,60900,20.37.198.118,443,9,1603,37,4,878,5,725,8.696194,30.338654,231,191,2
192.168.5.2,60992,20.52.64.201,443,11,5691,0,7,4981,4,710,0.0,5.515302,7224,1029,2
192.168.5.2,60075,20.189.173.27,443,11,3224,1,6,2740,5,484,0.001534,30.632837,715,126,2
192.168.5.2,61011,112.82.180.41,443,13,7548,10,7,2235,6,5313,3.339401,0.0240119999999999,744627,1770114,2
192.168.5.2,61013,112.82.180.41,443,16,7614,11,8,2193,8,5421,3.339533,0.030335,578341,1429635,2
192.168.5.2,61016,112.82.180.41,443,15,7560,12,7,2139,8,5421,3.339932,0.0284629999999999,601201,1523662,2
192.168.5.2,61019,112.82.180.41,443,16,7710,13,8,2289,8,5421,3.341016,0.02733,670032,1586827,2
192.168.5.2,61021,112.82.180.41,443,17,7732,14,8,2257,9,5475,3.341131,0.0260030000000002,694381,1684421,2
192.168.5.2,61196,121.199.251.28,80,10,1094,98,6,738,4,356,35.568179,0.8742230000000006,6753,3257,2
192.168.5.2,61067,221.5.100.174,2011,21,13051,35,9,4392,12,8659,8.444496000000001,0.1000689999999995,351117,692242,2
192.168.5.2,61084,221.5.100.174,2011,19,12447,43,8,3685,11,8762,11.524929,0.0974830000000004,302411,719058,2
192.168.5.2,61085,221.5.100.174,2011,19,11087,44,9,4479,10,6608,11.525896,0.0965559999999996,371100,547495,2
192.168.5.2,61093,221.5.100.174,2011,20,12512,48,9,3744,11,8768,11.642686,0.0994860000000006,301067,705064,2
192.168.5.2,61126,221.5.100.174,2011,23,15837,66,9,4238,14,11599,14.279128,0.1002650000000002,338143,925467,2
192.168.5.2,61127,221.5.100.174,2011,22,14688,67,8,3087,14,11601,14.279172,0.09938,248500,933869,2
192.168.5.2,61077,10.203.168.228,7680,8,539,41,5,365,3,174,9.74163,0.0170519999999996,171240,81632,1
192.168.5.2,60990,20.42.65.85,443,5,321,59,3,165,2,156,13.874601,30.517613000000004,43,40,1
192.168.5.2,60912,20.69.137.228,443,6,363,17,3,165,3,198,3.352091,30.435925999999995,43,52,1
192.168.5.2,60981,40.99.10.2,443,6,399,58,3,165,3,234,13.307734,30.196238,43,61,1
192.168.5.2,60906,101.126.24.53,443,6,363,2,3,165,3,198,0.264322,30.089238,43,52,1
192.168.5.2,60623,116.205.106.69,11112,2,133,25,1,55,1,78,4.138377,0.0257329999999997,17098,24249,1
192.168.5.2,61043,221.5.100.174,2011,17,4510,24,9,3974,8,536,4.084868,0.12108,262570,35414,1
192.168.5.2,61045,221.5.100.174,2011,15,4079,26,8,3609,7,470,4.174055,0.126176,228823,29799,1
192.168.5.2,61139,221.5.100.174,2011,16,4248,73,9,3778,7,470,14.495575,0.0936099999999999,322871,40166,1
192.168.5.2,60995,157.0.148.1,80,9,526,3,5,290,4,236,1.056538,0.0424539999999999,54647,44471,0
192.168.5.2,61080,157.0.148.1,80,9,526,42,5,290,4,236,11.119122,0.0485149999999983,47820,38915,0
192.168.5.2,61186,157.0.148.1,80,9,526,96,5,290,4,236,21.07481,0.0469110000000014,49455,40246,0
192.168.5.2,61190,157.0.148.1,80,9,526,97,5,290,4,236,31.140836,0.0392900000000011,59048,48052,0
192.168.5.2,61201,157.0.148.1,80,9,526,100,5,290,4,236,41.105719,0.0392209999999977,59151,48137,0
